11111111111111111111111111111111111111111111111111111111111111111111
1010010100100E001010010000000101000000000000000000000000000000000001
10000000000000C00000C00000000000000000000000000000000000000000000011
10100100101010100010010000000101000000000000000000000000000000000001
1P0000000C00C0000000000000000000C00000000000000000000000000000000001
11111111111111111111111111111111100000000000000000000000000000000001
10000000000000C00000C00000000000000000000000000000001100000000000011
10100101001000001010010000000101000000000000000000001100000000000001
10100100101010100010010000000101000000000000000000000000000000000001
110000000C00C0000000000000000000C00000000000000000000000000000000001
11111111111111111111111111111111100000000000000000000000000000000001
11111111111111111111111111111111100000000000000000000000000000000001
10000000000000C00000C00000000000000000000000011111110000000000000011
10100101001000001010010000000101000000000000000000000000000000000001
10100100101010100010010000000101000000000000000000000000000000000001
110000000C00C0000000000000000000C00000000000000000000000000000000001
11111111111111111111111111111111100000000000000000001000000000000001
11111111111111111111111111111111100000000000000000001000000000000001
10000000000000C00000C00000000000000000000000000000001000000000000011
10100101001000001010010000000101000000000000011111111000000000000001
10100100101010100010010000000101000000000000000000000000000000000001
110000000C00C0000000000000000000C00000000000000000000000000000000001
11111111111111111111111111111111111111111111111111111111111111111111